10 10
......X...
TX...XX..X
XX...X...X
X...XXX...
.....G....
XX..XGXX..
...XXXX...
XXXX..X...
S.........
XX...XX...
